#####
#@$.#
#####

;

 ########
##	#
#   .   #
#   $   #
# .$@$. #
####$   #
   #    #
   #   ##
   #####