#####
#PB #
#####

;

#########
# B     #
#      B#
#  P    #
####  B #
   #    #
   ######

;
 ####
##  #
#P  #
###B#
  # #
  # #
  ###